"a" = (/turf/unsimulated/mineral,/area/space)
"D" = (/obj/structure/sign/warning/lethal_turrets,/turf/simulated/wall,/area/space)
"F" = (/turf/simulated/floor/asteroid/dirt/dust,/area/space)
"P" = (/obj/random/turret/os,/turf/simulated/floor/snow,/area/space)
"U" = (/turf/simulated/floor/snow,/area/space)
"X" = (/turf/simulated/wall,/area/space)

(1,1,1) = {"
aaaaaaaaaaaaaaaaaaaaaaaaaaaaaaaaaaaaaaaaaaaaaaaaaaaaaaaaaaaaaaaaaaaaaaaaaaaaaaaaaaaaaaaaaaaaaaaaaaaa
aaFFFaaaaaaaaaaaaaaaaaaaaaaaaaaaaaaaaaaaaaaaaaaaaaaaaaaaaaaaaaaaaaaaaaaaaaaaaaaaaaaaaaaaaaaaaaaaaaaa
aaFFFaaaaaaaaaaaaaaaaaaaaaaaaaaaaaaaaaaaaaaaaaaaaaaaaaaaaaaaaaaaaaaaaaaaaaaaaaaaaaaaaaaaaaaaaaaaaaaa
aaFFFFaaaaaaaaaaaaaaaaaaaaaaaaaaaaaaaaaaaaaaaaaaaaaaaaaaaaaaaaaaaaaaaaaaaaaaaaaaaaaaaaaaaaaaaaaaaaaa
aaaaFFFaaaaaaaaaaaaaaaaaaaaaaaaaaaaaaaaaaaaaaaaaaaaaaaaaaaaaaaaaaaaaaaaaaaaaaaaaaaaaaaaaaaaaaaaaaaaa
aaaaaFFFaaaaaaaaaaaaaaaaaaaaaaaaaaaaaaaaaaaaaaXXXXXXXXXXXXXXXXXXXXXXXXXXXXXXXXXXXXXXXXXXXXXaaaaaaaaa
aaaaaaFFaaaaaaaaaaaaaaaaaaaaaaaaaaaaaaaaaaaaaaXXXXXXXXXXXXXXXXXXXXXXXXXXXXXXXXXXXXXXXXXXXXXaaaaaaaaa
aaaaaaaFFaaaaaaaaaaaaaaaaaaaaaaaaaaaaaaaaaaaaaXXXXXXXXXXXXXXXXXXXXXXXXXXXXXXXXXXXXXXXXXXXXXaaaaaaaaa
aaaaaaaaFFaaaaaaaaaaaaaaaaaaaaaaaaaaaaaaaaaaaaXXXXXXXXXXXXXXXXXXXXXXXXXXXXXXXXXXXXXXXXXXXXXaaaaaaaaa
aaaaaaaaFaaaaaaaaaaaaaaaaaaaaaaaaaaaaaaaaaaaaaXXXXXXXXXXXXXXXXXXXXXXXXXXXXXXXXXXXXXXXXXXXXXaaaaaaaaa
aaaaaaaaFFaaaaaaaaaaaaaaaaaaaaaaaaaaaaaaaaaaaaXXXXXXXXXXXXXXXXXXXXXXXXXXXXXXXXXXXXXXXXXXXXXaaaaaaaaa
aaaaaaaaFFaaaaaaaaaaaaaaaaaaaaaaaaaaaaaaaaaaaaXXXXXXXXXXXXXXXXXXXXXXXXXXXXXXXXXXXXXXXXXXXXXaaaaaaaaa
aaaaaaaaFFaaaaaaaaaaaaaaaaaaaaaaaaaaaaaaaaaaaaXXXXXXXXXXXXXXXXXXXXXXXXXXXXXXXXXXXXXXXXXXXXXaaaaaaaaa
aaaaaaaaFFFaaaaaaaaaaaaaaaaaaaaaaaaaaaaaaaaaaaXXXXXXXXXXXXXXXXXXXXXXXXXXXXXXXXXXXXXXXXXXXXXaaaaaaaaa
aaaaaaaaFFFaaaaaaaaaaaaaaaaaaaaaaaaaaaaaaaaaaaXXXXXXXXXXXXXXXXXXXXXXXXXXXXXXXXXXXXXXXXXXXXXaaaaaaaaa
aaaaaaaaaFFaaaaaaaaaaaaaaaaaaaaaaaaaaaaaaaaaaaXXXXXXXXXXXXXXXXXXXXXXXXXXXXXXXXXXXXXXXXXXXXXaaaaaaaaa
aaaaaaaaaFFaaaaaaaaaaaaaaaaaaaaaaaaaaaaaaaaaaaXXXXXXXXXXXXXXXXXXXXXXXXXXXXXXXXXXXXXXXXXXXXXaaaaaaaaa
aaaaaaaaaaFaaaaaaaaaaaaaaaaaaaaaaaaaaaaaaaaaaaXXXXXXXXXXXXXXXXXXXXXXXXXXXXXXXXXXXXXXXXXXXXXaaaaaaaaa
aaaaaaaaaaFFaaaaaaaaaaaaaaaaaaaaaaaaaaaaaaaaaaXXXXXXXXXXXXXXXXXXXXXXXXXXXXXXXXXXXXXXXXXXXXXaaaaaaaaa
aaaaaaaaaaFFaaaaaaaaaaaaaaaaaaaaaaaaaaaaaaaaaaXXXXXXXXXXXXXXXXXXXXXXXXXXXXXXXXXXXXXXXXXXXXXaaaaaaaaa
aaaaaaaaaaFFaaaaaaaaaaaaaaaaaaaaaaaaaaaaaaaaaaXXXXXXXXXXXXXXXXXXXXXXXXXXXXXXXXXXXXXXXXXXXXXaaaaaaaaa
aaaaaaaaaaFFaaaaaaaaaaaaaaaaaaaaaaaaaaaaaaaaaaXXXXXXXXXXXXXXXXXXXXXXXXXXXXXXXXXXXXXXXXXXXXXaaaaaaaaa
aaaaaaaaaaFFaaaaaaaaaaaaaaaaaaaaaaaaaaaaaaaaaaXXXXXXXXXXXXXXXXXXXXXXXXXXXXXXXXXXXXXXXXXXXXXaaaaaaaaa
aaaaaaaaaFFFaaaaaaaaaaaaaaaaaaaaaaaaaaaaaaaaaaXaaXaaaaaaaaaaaaaaaaaaaaaaXXXXXXXXXXXXXXXXXXXaaaaaaaaa
aaaaaaaaFFFaaaaaaaaaaaaaaaaaaaaaaaaaaaaaaaaaaaXaaXaaaaaaaaaaaaaaaaaaaaaaXXXXXXXXXXXXXXXXXXXaaaaaaaaa
aaaaaaaaFFFaaaaaaaaaaaaaaaaaaaaaaaaaaaaaaaaaaaDaaDaaaaaaaaaaaaaaaaaaaaaaXXXXXXXXXXXXXXXXXXXaaaaaaaaa
aaaaaaaaFFFaaaaaaaaaaaaaaaaaaaaaaaaaaaaaaaaaaaPFFPaaaaaaaaaaaaaaaaaaaaaaXXXXXXXXXXXXXXXXXXXaaaaaaaaa
aaaaaaaaFFaaaaaaaaaaaaaaaaaaaaaaaaaaaaaaaaaaaUUFFUUUaaaaaaaaaaaaaaaaaaaaXXXXXXXXXXXXXXXXXXXaaaaaaaaa
aaaaaaaaFFaaaaaaaaaaaaaaaaaaaaaaaaaaaaaaaaaUUUUFFUUUUaaaaaaaaaaaaaaaaaaaXXXXXXXXXXXXXXXXXXXaaaaaaaaa
aaaaaaaaFFFaaaaaaaaaaaaaaaaaaaaaaaaaaaaUUUUUUUUFFUUUUaaaaaaaaaaaaaaaaaaaXXXXXXXXXXXXXXXXXXXaaaaaaaaa
aaaaaaaaaaFFaaaaaaaaaaaaaaaaaaaaaaaaUUUUUUUUUUUFFUUUUaaaaaaaaaaaaaaaaaaaXXXXXXXXXXXXXXXXXXXaaaaaaaaa
aaaaaaaaaaFFFaaaaaaaaaaaaaaaaaaaaaUUUUUUUUUUUUUFFUUUUaaaaaaaaaaaaaaaaaaaXXXXXXXXXXXXXXXXXXXaaaaaaaaa
aaaaaaaaaaFFFFaaaaaaaaaaaaaaaaaaaUUUUUUUUUUUUUUFFUUUUaaaaaaaaaaaaaaaaaaaXXXXXXXXXXXXXXXXXXXaaaaaaaaa
aaaaaaaaaaaFFFFaaaaaaaaaaaaaaaaaUUUUUUUUUUUUUUUFFUUUUaaaaaaaaaaaaaaaaaaaXXXXXXXXXXXXXXXXXXXaaaaaaaaa
aaaaaaaaaaaaFFFaaaaaaaaaaaaaaaaaUUUUUUUUUUUUUUFFFUUUUaaaaaaaaaaaaaaaaaaaXXXXXXXXXXXXXXXXXXXaaaaaaaaa
aaaaaaaaaaaaaFFFaaaaaaaaaaaaaaaUUUUUUUUUUUUUUUFFFUUUUUUUUaaaaaaaaaaaaaaaXXXXXXXXXXXXXXXXXXXaaaaaaaaa
aaaaaaaaaaaaaFFFFaaaaaaaaaaaaUUUUUUUUUUUUUUUUFFFFUUUUUUUUUUUaaaaaaaaaaaaXXXXXXXXXXXXXXXXXXXaaaaaaaaa
aaaaaaaaaaaaaaFFFaaaaaaaaaaaUUUUUUUUUUUUUUUUFFFFFUUUUUUUUUUUaaaaaaaaaaaaXXXXXXXXXXXXXXXXXXXaaaaaaaaa
aaaaaaaaaaaaaaFFFaaaaaaaaaaaUUUUUUUUUUUUUUUFFFFFFUUUUUUUUaaaaaaaaaaaaaaaXXXXXXXXXXXXXXXXXXXaaaaaaaaa
aaaaaaaaaaaaaaaFFaaaaaaaaaaUUUUUUUUUUUUUUFFFFFFFUUUUUUUUUaaaaaaaaaaaaaaaXXXXXXXXXXXXXXXXXXXaaaaaaaaa
aaaaaaaaaaaaaaaUUFaaaaaaaaUUUUUUUUUUUUUUFFFFFFUUUUUUUUUUaaaaaaaaaaaaaaaaXXXXXXXXXXXXXXXXXXXaaaaaaaaa
aaaaaaaaaaaaaaaFUUFFaaaaaUUUUUUUUUUUUUFFFFFFUUUUUUUUUUUaaaaaaaaaaaaaaaaaXXXXXXXXXXXXXXXXXXXaaaaaaaaa
aaaaaaaaaaaaaaaUUUFUUaaaUUUUUUUUUUUUFFFFFFUUUUUUUUUUUUUUaaaaaaaaaaaaaaaaXXXXXXXXXXXXXXXXXXXaaaaaaaaa
aaaaaaaaaaaaaaaaaUUUUUUUUUUUUUUUFFFFFFFUUUUUUUUUUUUUUUUUUaaaaaaaaaaaaaaaXXXXXXXXXXXXXXXXXXXaaaaaaaaa
aaaaaaaaaaaaaaaaaaaUUUUUUUUUFFFFFFFFUUUUUUUUUUUUUUUUUUUUUaaaaaaaaaaaaaaaXXXXXXXXXXXXXXXXXXXaaaaaaaaa
aaaaaaaaaaaaaaaaaaaaUUUUUUFFFFFFFUUUUUUUUUUUUUUUUUUUUUUUUUaaaaaaaaaaaaaaXXXXXXXXXXXXXXXXXXXaaaaaaaaa
aaaaaaaaaaaaaaaaaaaaUUUUUFFFFFUUUUUUUUUUUUUUUUUUUUUUUUUUUUaaaaaaaaaaaaaaXXXXXXXXXXXXXXXXXXXaaaaaaaaa
aaaaaaaaaaaaaaaaaaaaaUUUFFFUUUUUUUUUUUUUUUUUUUUUUUUUUUUUUUaaaaaaaaaaaaaaXXXXXXXXXXXXXXXXXXXaaaaaaaaa
aaaaaaaaaaaaaaaaaaaaaUUUFFUUUUUUUUUUUUUUUUUUUUUUUUUUUUUUUUaaaaaaaaaaaaaaXXXXXXXXXXXXXXXXXXXaaaaaaaaa
aaaaaaaaaaaaaaaaaaaaaUUFFFUUaUUUUUUUUUUUUUUUUUUUUUUUUUUUUaaaaaaaaaaaaaaaXXXXXXXXXXXXXXXXXXXaaaaaaaaa
aaaaaaaaaaaaaaaaaaaaaUUFFFUaaaaUUUUUUUUUUUUUUUUUUUUUUUUUaaaaaaaaaaaaaaaaXXXXXXXXXXXXXXXXXXXaaaaaaaaa
aaaaaaaaaaaaaaaaaaaaaUUFFUUaaaaaaUUUUUUUUUUUUUUUUUUUUUUaaaaaaaaaaaaaaaaaXXXXXXXXXXXXXXXXXXXaaaaaaaaa
aaaaaaaaaaaaaaaaaaaaUUUFFUUaaaaaaaaUUUUUUUUUUUUUUUUUUUaaaaaaaaaaaaaaaaaaXXXXXXXXXXXXXXXXXXXaaaaaaaaa
aaaaaaaaaaaaaaaaaaaaUUUFUUUUaaaaaaaaUUUUUUUUUUUUUUUUUaaaaaaaaaaaaaaaaaaaXXXXXXXXXXXXXXXXXXXaaaaaaaaa
aaaaaaaaaaaaaaaaaaaUUUUFUUUUaaaaaaaUUUUUaaUUUUUUUUUUUaaaaaaaaaaaaaaaaaaaaaaaaaaaaaaaaaaaaaaaaaaaaaaa
aaaaaaaaaaaaaaaaaaaUUUUFUUUUaaaaaaaUUUUaaaaaaaaUUUUUUaaaaaaaaaaaaaaaaaaaaaaaaaaaaaaaaaaaaaaaaaaaaaaa
aaaaaaaaaaaaaaaaaaUUUUUFUUUUaaaaaaUUUUUaaaaaaaaaUUUUaaaaaaaaaaaaaaaaaaaaaaaaaaaaaaaaaaaaaaaaaaaaaaaa
aaaaaaaaaaaaaaaaaaUUUUUUUUUUaaaaaaUUUUUaaaaaaaaUUUUaaaaaaaaaaaaaaaaaaaaaaaaaaaaaaaaaaaaaaaaaaaaaaaaa
aaaaaaaaaaaaaaaaaUUUUUFUUUUaaaaaaaUUUUUaaaaaaaUUUUUaaaaaaaaaaaaaaaaaaaaaaaaaaaaaaaaaaaaaaaaaaaaaaaaa
aaaaaaaaaaaaaaaaaUUUUUFUUUUaaaaaaaUUUUUaaaaaaaUUUUUaaaaaaaaaaaaaaaaaaaaaaaaaaaaaaaaaaaaaaaaaaaaaaaaa
aaaaaaaaaaaaaaaaUUUUUFFFUUUaaaaaaUUUUUUUaaaaaUUUUUUaaaaaaaaaaaaaaaaaaaaaaaaaaaaaaaaaaaaaaaaaaaaaaaaa
aaaaaaaaaaaaaaaaUUUUFFFUUUUaaaaaaUUUUUUUaaUUUUUUUUaaaaaaaaaaaaaaaaaaaaaaaaaaaaaaaaaaaaaaaaaaaaaaaaaa
aaaaaaaaaaaaaaaaUUUUFFUUUUaaaaaaaUUUUUUUaUUUUUUUUaaaaaaaaaaaaaaaaaaaaaaaaaaaaaaaaaaaaaaaaaaaaaaaaaaa
aaaaaaaaaaaaaaaUUUUFFFUUUUaaaaaaaUUUUUUUUUUUUUUUaaaaaaaaaaaaaaaaaaaaaaaaaaaaaaaaaaaaaaaaaaaaaaaaaaaa
aaaaaaaaaaaaaaUUUUUFFUUUUUaaaaaaaUUUUUUUUUUUUUaaaaaaaaaaaaaaaaaaaaaaaaaaaaaaaaaaaaaaaaaaaaaaaaaaaaaa
aaaaaaaaaaaaUUUUUUFFFUUUUUaaaaaaaUUUUUUUUUUUaaaaaaaaaaaaaaaaaaaaaaaaaaaaaaaaaaaaaaaaaaaaaaaaaaaaaaaa
aaaaaaaaaaaUUUUUUUFFFUUUUaaaaaaaaaUUUUUUaaaaaaaaaaaaaaaaaaaaaaaaaaaaaaaaaaaaaaaaaaaaaaaaaaaaaaaaaaaa
aaaaaaaaaaUUUUUUUFFFFUUUUaaaaaaaaaUUUUUUaaaaaaaaaaaaaaaaaaaaaaaaaaaaaaaaaaaaaaaaaaaaaaaaaaaaaaaaaaaa
aaaaaaaaUUUUUUUUFFFFUUUUaaaaaaaaaUUUUUUaaaaaaaaaaaaaaaaaaaaaaaaaaaaaaaaaaaaaaaaaaaaaaaaaaaaaaaaaaaaa
aaaaaaaUUUUUUUUFFFFUUUUUUUaaaaaUUUUUUaaaaaaaaaaaaaaaaaaaaaaaaaaaaaaaaaaaaaaaaaaaaaaaaaaaaaaaaaaaaaaa
aaaaaaUUUUUUUUFFFUUUUUUUUUUUUUUUUUUUUaaaaaaaaaaaaaaaaaaaaaaaaaaaaaaaaaaaaaaaaaaaaaaaaaaaaaaaaaaaaaaa
aaaaUUUUUUUUUFFFFUUUUUUUUUUUUUUUUUUUaaaaaaaaaaaaaaaaaaaaaaaaaaaaaaaaaaaaaaaaaaaaaaaaaaaaaaaaaaaaaaaa
aaUUUUUUUUUFFFFFUUUUUUUUUUUUUUUUUUUaaaaaaaaaaaaaaaaaaaaaaaaaaaaaaaaaaaaaaaaaaaaaaaaaaaaaaaaaaaaaaaaa
aaUUUUUUFFFFFFUUUUUUUUUaUUUUUUUaaaaaaaaaaaaaaaaaaaaaaaaaaaaaaaaaaaaaaaaaaaaaaaaaaaaaaaaaaaaaaaaaaaaa
aaUUUUUUUUUUUUUUUUUUaaaaaaaaaaaaaaaaaaaaaaaaaaaaaaaaaaaaaaaaaaaaaaaaaaaaaaaaaaaaaaaaaaaaaaaaaaaaaaaa
aaUUUUUUUUUUUUUUUUUUaaaaaaaaaaaaaaaaaaaaaaaaaaaaaaaaaaaaaaaaaaaaaaaaaaaaaaaaaaaaaaaaaaaaaaaaaaaaaaaa
aaaaaaaaaaaaaaaaaaaaaaaaaaaaaaaaaaaaaaaaaaaaaaaaaaaaaaaaaaaaaaaaaaaaaaaaaaaaaaaaaaaaaaaaaaaaaaaaaaaa
aaaaaaaaaaaaaaaaaaaaaaaaaaaaaaaaaaaaaaaaaaaaaaaaaaaaaaaaaaaaaaaaaaaaaaaaaaaaaaaaaaaaaaaaaaaaaaaaaaaa
aaaaaaaaaaaaaaaaaaaaaaaaaaaaaaaaaaaaaaaaaaaaaaaaaaaaaaaaaaaaaaaaaaaaaaaaaaaaaaaaaaaaaaaaaaaaaaaaaaaa
aaaaaaaaaaaaaaaaaaaaaaaaaaaaaaaaaaaaaaaaaaaaaaaaaaaaaaaaaaaaaaaaaaaaaaaaaaaaaaaaaaaaaaaaaaaaaaaaaaaa
aaaaaaaaaaaaaaaaaaaaaaaaaaaaaaaaaaaaaaaaaaaaaaaaaaaaaaaaaaaaaaaaaaaaaaaaaaaaaaaaaaaaaaaaaaaaaaaaaaaa
aaaaaaaaaaaaaaaaaaaaaaaaaaaaaaaaaaaaaaaaaaaaaaaaaaaaaaaaaaaaaaaaaaaaaaaaaaaaaaaaaaaaaaaaaaaaaaaaaaaa
aaaaaaaaaaaaaaaaaaaaaaaaaaaaaaaaaaaaaaaaaaaaaaaaaaaaaaaaaaaaaaaaaaaaaaaaaaaaaaaaaaaaaaaaaaaaaaaaaaaa
aaaaaaaaaaaaaaaaaaaaaaaaaaaaaaaaaaaaaaaaaaaaaaaaaaaaaaaaaaaaaaaaaaaaaaaaaaaaaaaaaaaaaaaaaaaaaaaaaaaa
aaaaaaaaaaaaaaaaaaaaaaaaaaaaaaaaaaaaaaaaaaaaaaaaaaaaaaaaaaaaaaaaaaaaaaaaaaaaaaaaaaaaaaaaaaaaaaaaaaaa
aaaaaaaaaaaaaaaaaaaaaaaaaaaaaaaaaaaaaaaaaaaaaaaaaaaaaaaaaaaaaaaaaaaaaaaaaaaaaaaaaaaaaaaaaaaaaaaaaaaa
aaaaaaaaaaaaaaaaaaaaaaaaaaaaaaaaaaaaaaaaaaaaaaaaaaaaaaaaaaaaaaaaaaaaaaaaaaaaaaaaaaaaaaaaaaaaaaaaaaaa
aaaaaaaaaaaaaaaaaaaaaaaaaaaaaaaaaaaaaaaaaaaaaaaaaaaaaaaaaaaaaaaaaaaaaaaaaaaaaaaaaaaaaaaaaaaaaaaaaaaa
aaaaaaaaaaaaaaaaaaaaaaaaaaaaaaaaaaaaaaaaaaaaaaaaaaaaaaaaaaaaaaaaaaaaaaaaaaaaaaaaaaaaaaaaaaaaaaaaaaaa
aaaaaaaaaaaaaaaaaaaaaaaaaaaaaaaaaaaaaaaaaaaaaaaaaaaaaaaaaaaaaaaaaaaaaaaaaaaaaaaaaaaaaaaaaaaaaaaaaaaa
aaaaaaaaaaaaaaaaaaaaaaaaaaaaaaaaaaaaaaaaaaaaaaaaaaaaaaaaaaaaaaaaaaaaaaaaaaaaaaaaaaaaaaaaaaaaaaaaaaaa
aaaaaaaaaaaaaaaaaaaaaaaaaaaaaaaaaaaaaaaaaaaaaaaaaaaaaaaaaaaaaaaaaaaaaaaaaaaaaaaaaaaaaaaaaaaaaaaaaaaa
aaaaaaaaaaaaaaaaaaaaaaaaaaaaaaaaaaaaaaaaaaaaaaaaaaaaaaaaaaaaaaaaaaaaaaaaaaaaaaaaaaaaaaaaaaaaaaaaaaaa
aaaaaaaaaaaaaaaaaaaaaaaaaaaaaaaaaaaaaaaaaaaaaaaaaaaaaaaaaaaaaaaaaaaaaaaaaaaaaaaaaaaaaaaaaaaaaaaaaaaa
aaaaaaaaaaaaaaaaaaaaaaaaaaaaaaaaaaaaaaaaaaaaaaaaaaaaaaaaaaaaaaaaaaaaaaaaaaaaaaaaaaaaaaaaaaaaaaaaaaaa
aaaaaaaaaaaaaaaaaaaaaaaaaaaaaaaaaaaaaaaaaaaaaaaaaaaaaaaaaaaaaaaaaaaaaaaaaaaaaaaaaaaaaaaaaaaaaaaaaaaa
aaaaaaaaaaaaaaaaaaaaaaaaaaaaaaaaaaaaaaaaaaaaaaaaaaaaaaaaaaaaaaaaaaaaaaaaaaaaaaaaaaaaaaaaaaaaaaaaaaaa
aaaaaaaaaaaaaaaaaaaaaaaaaaaaaaaaaaaaaaaaaaaaaaaaaaaaaaaaaaaaaaaaaaaaaaaaaaaaaaaaaaaaaaaaaaaaaaaaaaaa
aaaaaaaaaaaaaaaaaaaaaaaaaaaaaaaaaaaaaaaaaaaaaaaaaaaaaaaaaaaaaaaaaaaaaaaaaaaaaaaaaaaaaaaaaaaaaaaaaaaa
aaaaaaaaaaaaaaaaaaaaaaaaaaaaaaaaaaaaaaaaaaaaaaaaaaaaaaaaaaaaaaaaaaaaaaaaaaaaaaaaaaaaaaaaaaaaaaaaaaaa
"}
